|||||||||||||||||||||||||||||||||||||
|.....|.................|.........|.|
|.|||.|.|||.|||||||.|||.|.........|.|
|.|...|.|......|.P....|.|.........|.|
|...|||.|.||||.|.||||...|||.......|.|
|||.|.|.|.|......|..|.|...|.|.|||.|.|
|...|.|||.|.||XXX||.|.|||.|.|...|...|
|.|||.......|  G  |.......|||.|.|||.|
|...|.|||||.|||||||.|.|||.|...|.|...|
|||.|...|.|....|....|.|...|.|||.|.|||
|...|||.|.||||.|.||||.|.|||...|.|...|
|.......|......|......|.......|.|.|.|
|.....|.|||.|||||||.|||.|.|||.|.|.|.|
|.....|.............|...|.....|.|...|
|...................................|
|||||||||||||||||||||||||||||||||||||