|||||||||||||||||||||||||||||||
|.....|.................|.....|
|.|||.|.|||.|||||||.|||.|.....|
|.|...|.|......|.P....|.|.....|
|...|||.|.||||.|.||||...|||...|
|||.|.|.|.|......|..|.|...|.|||
|...|.|||.|.||XXX||.|.|||.|...|
|.|||.......|  G  |.......|||.|
|...|.|||||.|||||||.|.|||.|...|
|||.|...|.|....|....|.|...|.|||
|...|||.|.||||.|.||||.|.|||...|
|.......|......|......|.....|.|
|.....|.|||.|||||||.|||.|.|||.|
|.....|.............|...|.....|
|||||||||||||||||||||||||||||||