||||||||||||||||||||
|....|........|....|
|.||.|.||||||.|.||.|
|.|...........P..|.|
|.|.||.||XX||.||.|.|
|......|  G |......|
|.|.||.||||||.||.|.|
|.|..............|.|
|.||.|.||||||.|.||.|
|....|........|....|
||||||||||||||||||||
